

......B.B......
...............
......B.B......
...............
.....AAAAA.....
...............
...AAABABAAA...
...............
.AAAAAAAAAAAAA.
...............
...............
...............
...............
...............
......C........