.AAABABABABAAA.
..BBAABABAABB..
...BBAAAAABB...
.B.AAABABAAA.B.
.AAAAAAAAAAAAA.
