AAAAAAAAAAAAAAA
BBBAAABABAAABBB
AAABBAAAAABBAAA
BBBAAABABAAABBB
AAAAAAAAAAAAAAA
