.AAA..B.B..AAA.
....AAB.BAA....
...B.AAAAA.B...
.B.AAABABAAA.B.
.AAAAAAAAAAAAA.
